111111111111111111111111111111113111111111111111111111111111
100200000000002000000200000000020200002000200020020020000001
100222022222202222220202222220220202022220002000020000220201
100000020200202000000000000020000002020202022022000200000201
102222020000200022222222222020222202020200000000222222222001
102000020200002000002000200000020202020000220020200200002021
102020200222202020202020202020000202000200020020200202202001
102020000000002000200020002022220022222202222220000002002201
102020022222202222222222222220000020000000000020022022202001
100020020202002000202000202000202000002222002000002000000001
122002020202022020200020000022202220002020022022222202200001
100002020000020020002222202220000022202000020000000000000221
102222020222222222200000002020022220222222022202202022222201
100002020000000000200202202020000020020000020000002000000201
102002020222222220200200200000020000000220020000002002000201
102002020000000222222222222222022222222222022220202022220201
102002022222220000000000020000020000020000000200202000000001
122022020202020222222222000020220222022222020220002000020201
100000020000000000000000000020000002000000020000202002020201
120222020222222202020202020222222022220222222202222022222201
100002020200200002000000020020000002000020020002002020200201
100002020202202222220222002020222222222020020002020000000201
100222020000000000020020002020000000002020222220000202020001
120002020220020222222220202022222020200000000020222202020201
100202020020020200000000202000002020222222202020202002020201
102202020020020002022220202020000020000200002000200002000201
100202020020020002020020000022222222222220222222202222202201
120202022022000000000020202000000020000020000202000020200201
100202020000020002022222202022222022200020020202020020200201
102202020222020000002002002220200000002222020000020020000201
100202020000020002002002200200002222200020022222220020220201
120202022000222222002000000000000020002000002020020000000001
100202020020200000000000000022202222222222200020000222220221
100022020220222222222222222220000002000020202000020202020001
102002020200000000200002000020002022022000202000020000020201
102002020222022020202022000020202002002022222222020020000201
102022000000002020200202002000200022022020000000000020020201
102000020220202020200002002020222000020020222222020222220201
100200020020200020002000002020000020000000200000020000000001
111111111111111111111111111111111111111111111111111111111111