111111111111111111111111111111111111111111111111111111111111
100200000000002000000200000000000000000000000000000000000001
100222022222202222220202222220020202002020002000200000200001
100000020220202000000000000020020200002222020202020202020201
102222020000200022222222222020200202000000002000222220222001
102000020200002000002000200000020202000002000200220200002021
102020000222202020202020202020000202020000020000000002002001
102020000000002000200020002022222022222202222220202222220001
102020022222202222222222222220000202000000000020022222202001
100020020202002000202020202020202020000020002002202000020001
102002020202002020200000000022202202020202022222222222200001
102002020000000020002222202220020020202020020202000000000201
102222020222222222200200000002022220222222022222202022222201
100002020000000000200222222020202020220002022200000000020001
102002020222222220200000000000000202020220222222020202200001
102002020000000222022022222220000000000000000000000000000001
100002022222220000000000000000020202200020222000000000200001
122022020202020222222222222020200020202200202222222002020001
100002020000000000000000000020220202002002002002002020000001
122222020222222202020202020220002020200200200020202022000001
100002020200000000000000020020020200000000020002000200020221
100002020202202222220202022020020202022000202220000000002001
100222020000000000020020022020002020200000200200222022020201
120002020220020222222200202020020202000002002002220220202001
100202020020020200000002202000220220202020202222222222220001
102202020020020020020020202020202020220220002000022022020201
100202020020020002020202200020202022022000200002202202020001
120202022022000200002202202020222202022222220202020202022001
100202020000020020022202202020020020202000000002000020000201
102202020222002000200002002220220220202020202222222222220201
100202020000020002002202000020002020200202000200020000020201
120202022000202220000000002000200202022222222020000222000001
100202020020200000202020020020200202020000000020000202020201
100022020220222222222222222220222220202222222020202020202201
102002020200000000200002000020020220000002000202002020020001
102002020222000020202022000020002220200000000000200200220201
102022000000200020200202002000020020202222222202000000000001
102000020220000020200002002020000222202022222220202020202001
100202020020200020002000002020000020200000000002002222220201
111111111111111111111111111111111111111111111111111111111111
