111111111111111111111111111111111111111111111111111111111111
100200000000002000000200000000000000000000000000000000000001
100222022222202222220200000000000000000000000000000000000001
100000020000000000000000000000000000000000000000000000000001
102222020000000000000000000000000000000000000000000000000001
102002020000000000000000000000000000000000000000000000000001
102002020000000000000000000000000000000000000000000000000001
102002020000000000000000000000000000000000000000000000000001
102002020000000000000000000000000000000000000000000000000001
100002020000000000000000000000000000000000000000000000000001
102002020000000000000000000000000000000000000000000000000001
102002020000000000000000000000000000000000000000000000000001
102222020000000000000000000000000000000000000000000000000001
100002020000000000000000000000000000000000000000000000000001
102002020000000000000000000000000000000000000000000000000001
102002020000000000000000000000000000000000000000000000000001
100002020000000000000000000000000000000000000000000000000001
122022020000000000000000000000000000000000000000000000000001
100002020000000000000000000000000000000000000000000000000001
122222020000000000000000000000000000000000000000000000000001
100002020000000000000000000000000000000000000000000000000001
100002020000000000000000000000000000000000000000000000000001
100002020000000000000000000000000000000000000000000000000001
100002020000000000000000000000000000000000000000000000000001
100002020000000000000000000000000000000000000000000000000001
100002020000000000000000000000000000000000000000000000000001
100002020000000000000000000000000000000000000000000000000001
100002020000000000000000000000000000000000000000000000000001
100002020000000000000000000000000000000000000000000000000001
100002020000000000000000000000000000000000000000000000000001
100002020000000000000000000000000000000000000000000000000001
100002020000000000000000000000000000000000000000000000000001
100002020000000000000000000000000000000000000000000000000001
100002020000000000000000000000000000000000000000000000000001
100002020000000000000000000000000000000000000000000000000001
100002020000000000000000000000000000000000000000000000000001
100002000000000000000000000000000000000000000000000000000001
100000000000000000000000000000000000000000000000000000000001
100000000000000000000000000000000000000000000000000000000001
111111111111111111111111111111111111111111111111111111111111
