666666666666666666666666666666666666666666666666666666666666
600050000005000000000000005000000005000000000000000000050006
600050000005000050055500000500000005050000000005005000005006
600000500005000050055500000050005505005005500555005000500506
600000500005000000055500000005000005000050000000505005000006
655550500005000050000000000000500000000500005000500050000006
600000000005555005550555555550550555555555055505555055550556
600005550000000000000000000000000000050000000000000005000006
600005555555555050000000000055000000005000000000000055000056
655500000000000050000500500055000000000500000000000500500506
650000500555555050005000050000550000000050000050000500000006
650000500000050050000500500000550000500005000505000000000006
600055500000050050005000000000000005000000050000000500500506
600050000000050050000505000000000050000050005500000055000056
600050500050050050000000555550555500000500000500000005000006
600050000000050000005000050000000500005000000055550000550556
600050005000000050000500050000000500000055000000000000000006
600050505000050050000000050000000500000055000000000000000006
600000005000050000005000000000000000055000005000000000000006
650050005000050050000500050000000500055000050005050055000006
650050000000050050005000050000000500000000050005050000500006
655055555505550050000000050000000500000000500005050000050006
600000500000000000000000055550555500000005000000000500000006
605000500000000050000000500000000050000005000000500500000006
600050505005000050000005000005000005000005000000000500000006
605000500005500050000055055500055505500000000005050000000006
600050500000000000000000000000000000000000000005050000000006
600000500000000050005055055550555505505000000005050000005006
655500500500000050050000000000000500000500000000000005555006
600000000550000050000005000000000500000000000000000050005006
605000000055000050000055000505000000000000000050000000000006
605000000005500050050005000050050000500005505500005005555056
605000550000500000055000000000050005000050000000050050000006
605000550000000050000005000500050000005000000000500500000006
600000000000000050055005000505000000000500000000500500505006
605000000000000050050000000005000500500050050000000500050006
605000000000000000000055000005000500000005555000000500500006
605055055500000050050005000005005000000000000000500000000506
600000000000000050050005000000050000000000000000500500000006
666666666666666666666666666666666666666666666666666666666666
