111111111111111111111111111111111111111111111111111111111111
100000000000000000000000000000000000000000000000000000000001
100201111020200021111100002020000020000001111100020000000001
100000000000000000000000000000000000000000000000000000000001
100000000000000000000000000000000000000000000000000000000001
100201111020200021111100002020000020000001111100020000000001
100000000000000000000000000000000000000000000000000000000001
100000000000000000000000000000000000000000000000000000000001
100201111020200021111100002020000020000001111100020000000001
100000000000000000000000000000000000000000000000000000000001
100000000000000000000000000000000000000000000000000000000001
100201111020200021111100002020000020000001111100020000000001
100000000000000000000000000000000000000000000000000000000001
100000000000000000000000000000000000000000000000000000000001
100201111020200021111100002020000020000001111100020000000001
100000000000000000000000000000000000000000000000000000000001
100000000000000000000000000000000000000000000000000000000001
100201111020200021111100002020000020000001111100020000000001
100000000000000000000000000000000000000000000000000000000001
100000000000000000000000000000000000000000000000000000000001
100201111020200021111100002020000020000001111100020000000001
100000000000000000000000000000000000000000000000000000000001
100000000000000000000000000000000000000000000000000000000001
100201111020200021111100002020000020000001111100020000000001
100000000000000000000000000000000000000000000000000000000001
100000000000000000000000000000000000000000000000000000000001
100201111020200021111100002020000020000001111100020000000001
100000000000000000000000000000000000000000000000000000000001
100000000000000000000000000000000000000000000000000000000001
100201111020200021111100002020000020000001111100020000000001
100000000000000000000000000000000000000000000000000000000001
100000000000000000000000000000000000000000000000000000000001
100201111020200021111100002020000020000001111100020000000001
100000000000000000000000000000000000000000000000000000000001
100000000000000000000000000000000000000000000000000000000001
100201111020200021111100002020000020000001111100020000000001
100000000000000000000000000000000000000000000000000000000001
100000000000000000000000000000000000000000000000000000000001
100201111020200021111100002020000020000001111100020000000001
111111111111111111111111111111111111111111111111111111111111