666666666666666666666666666666666666666666666666666666666666
600000000000000000000000000000000000000000000000000000000006
655555555555550055555555550055555555555555555555555555555556
600000000000000000000000050000000000000000000000000000000006
600000000000000000000000050000000000000000000000000000000006
600000000000000000000000050000000000000000000000000000000006
600000000000000000000000050000000000000000000000000000000006
600000000000000000000000050000000000000000000000000000000006
600000000000000000000000050000000000000000000000000000000006
600000000000000000000000055555555555555555555555555555555556
600000000000000000000000000000000000000000000000000000000006
600000000000000000000000050000000000000000000000000000000006
600000000000000000000000050000000000000000000000000000000006
600000000000000000000000050000000000000000000000000000000006
600000000000000000000000000000000000000000000000000000000006
600000000000000000000000000000000000000000000000000000000006
600000000000000000000000000000000000000000000000000000000006
600000000000000000000000000000000000000000000000000000000006
600000000000000000000000000000000000000000000000000000000006
600000000000000000000000000000000000000000000000000000000006
600000000000000000000000000000000000000000000000000000000006
600000000000000000000000000000000000000000000000000000000006
600000000000000000000000000000000000000000000000000000000006
600000000000000000000000000000000000000000000000000000000006
600000000000000000000000000000000000000000000000000000000006
600000000000000000000000000000000000000000000000000000000006
600000000000000000000000000000000000000000000000000000000006
600000000000000000000000000000000000000000000000000000000006
600000000000000000000000000000000000000000000000000000000006
600000000000000000000000000000000000000000000000000000000006
600000000000000000000000000000000000000000000000000000000006
600000000000000000000000000000000000000000000000000000000006
600000000000000000000000000000000000000000000000000000000006
600000000000000000000000000000000000000000000000000000000006
600000000000000000000000000000000000000000000000000000000006
600000000000000000000000000000000000000000000000000000000006
600000000000000000000000000000000000000000000000000000000006
600000000000000000000000000000000000000000000000000000000006
600000000000000000000000000000000000000000000000000000000006
666666666666666666666666666666666666666666666666666666666666