111111111111111111111111111111111111111111111111111111111111
100000000000002000000000000002200000000000000000000000000021
100000000000002000000000000002200000000000000000000000000201
100002222222222000000000000000000000000000000000000000002001
100000000000000000000000000000000000000000000000000000000001
100020222222222000222222222220022222222222000222222222200001
100020200000002000200000000020020000000002002000000000200001
100020200000020000020000000020020000000020020000000002000001
100020222200200202002000000020020000000200200000000020000001
100000000202002202200200000020020000002002000000000200200001
100000000220020202020020000020020000020000200000002002200001
100000000000200202002002000020020000200220020000020020200001
100000000222000202020200200200002002002002002000200200200001
100000000020000202000020022000000220020000200202002000200001
100022222002000202202002000002200000200000020020020000200001
100002000200200202000000200000000002000000002000200000200001
100002000020020202020202000000000000200000002002000000200001
100002000002002202200020000200002000020000020020000000200001
100002000000200002000020000000000000020000200200000000200001
100002222222220002222220000000000000022222002222222222200001
100000000000000000000000020000000020000000000000000000000001
100002222222222200222220000000000000022222002222222222200001
100002000000002002000020000000000000020000200200000000200001
100002000000020020000020000200002000020000020020000000200001
100002000000200200000002000000000000200000002002000000200001
100002000002002000000000200000000000200000000200200000200001
100002000020020000000002000002200000200000000020020000200001
100002000200200000000020022000000220020000000002002000200001
100002002002000000000200200200002002002000000000200200200001
100002020022222220002002000020020000200200022222220020200001
100002200200000020020020000020020000020020020000000002200001
100002002000000020200200000020020000002002020000000000200001
100000020000000022002000000020020000000200220000000000000001
100000200000000020020000000020020000000020020000000000000001
100002222222222222222222222220022222222222222222222222200001
100000000000000000000000000000000000000000000000000000000001
100200000000000000000000000000000000000000000000000000002001
102000000000000000000000000002200000000000000000000000000201
120000000000000000000000000002200000000000000000000000000021
111111111111111111111111111111111111111111111111111111111111
