111111111111111111111111111111111111111111111111111111111111
100000000000002000000000000002200000000000000000000000000021
100000000000002000000000000002200000000000000000000000000201
100002222222222000000000000000000000000000000000000000002001
100000000000000000000000000000000000000000000000000000000001
100020222222222000222222222220022222222222000222222222200001
100020222222222000222222222220022222222222002222222222200001
100020222222220000022222222220022222222220022222222222000001
100020222222200202002222222220022222222200222222222220000001
100000000222002202200222222220022222222002222222222200200001
100000000220022202220022222220022222220000222222222002200001
100000000000222202222002222220022222200220022222220022200001
100000000222222202222200222200002222002222002222200222200001
100000000022222202222220022000000220022222200222002222200001
100022222002222202222222000002200000222222220020022222200001
100002222200222202222222200000000002222222222000222222200001
100002222220022202222222000000000000222222222002222222200001
100002222222002202222220000200002000022222220022222222200001
100002222222200002222220000000000000022222200222222222200001
100002222222220002222220000000000000022222002222222222200001
100000000000000000000000020000000020000000000000000000000001
100002222222222200222220000000000000022222002222222222200001
100002222222222002222220000000000000022222200222222222200001
100002222222220022222220000200002000022222220022222222200001
100002222222200222222222000000000000222222222002222222200001
100002222222002222222222200000000000222222222200222222200001
100002222220022222222222000002200000222222222220022222200001
100002222200222222222220022000000220022222222222002222200001
100002222002222222222200222200002222002222222222200222200001
100002220022222222222002222220022222200222222222220022200001
100002200222222222220022222220022222220022220000000002200001
100002002222222222200222222220022222222002220000000000200001
100000022222222222002222222220022222222200220000000000000001
100000222222222220022222222220022222222220020000000000000001
100002222222222220022222222220022222222220022222222222200001
100000000000000000000000000000000000000000000000000000000001
100200000000000000000000000000000000000000000000000000002001
102000000000000000000000000002200000000000000000000000000201
120000000000000000000000000002200000000000000000000000000021
111111111111111111111111111111111111111111111111111111111111
